TheTestTown
16 20
11 31 33 33 33 31 11 11 31 33 33 33 33 31 11 11 51 52 52 53
11 31 33 33 33 31 11 11 31 33 33 33 33 31 11 11 51 52 52 53
11 31 31 31 31 31 11 11 31 31 41 42 31 31 11 11 51 52 52 53
11 11 11 11 11 11 11 11 11 11 11 11 11 11 11 11 11 11 11 11
11 31 102 102 101 101 101 101 101 101 101 101 101 101 101 101 31 31 31 11
11 31 102 102 101 101 101 101 101 101 101 101 101 101 101 101 31 111 31 11
11 31 102 102 101 101 101 101 101 101 101 101 101 101 101 101 31 31 31 11
11 11 11 11 11 11 11 11 11 11 11 11 11 11 11 11 11 11 11 11
11 11 11 11 11 11 11 11 11 11 11 11 11 11 11 11 11 11 11 11
11 31 102 102 101 101 101 101 101 101 101 101 101 101 101 101 31 31 31 11
11 31 102 102 101 101 101 101 101 101 101 101 101 101 101 101 31 111 31 11
11 31 102 102 101 101 101 101 101 101 101 101 101 101 101 101 31 31 31 11
11 11 11 11 11 11 11 11 11 11 11 11 11 11 11 11 11 11 11 11
11 31 31 31 31 31 11 11 31 31 31 31 31 31 31 31 31 31 31 31
11 31 33 33 33 31 11 11 31 32 32 32 32 32 32 32 32 31 25 25
54 31 33 33 33 31 11 11 31 32 32 32 32 32 32 32 32 31 25 60
0
1
15 0 1 5 0 5 1
